%%%%%%%%%%%%%%%%%%%%%%
%.......%G  G%.......%
%..%%...%%  %%...%%..%
%..%%.%........%.%%..%
%..%%.%.%%%%%%.%.%%..%
%.........P.......P..%
%%%%%%%%%%%%%%%%%%%%%%
