%%%%%%%%%%%%%%%%%%%%%%
%.......%  G %.......%
%..%%...%%  %%...%%..%
%..%%.%........%.%%..%
%..%%.%.%%%%%%.%.%%..%
%.PP...............PP%
%%%%%%%%%%%%%%%%%%%%%%
