%%%%%%%%%%%%%%%%%%%%%%%%%
%...   ....      ....   %
%..  ...  ...  ...  ... %
%..  ...  ...  ...  ... %
%..    ....      .... G %
%..  ...  ...  ...  ... %
%..  ...  ...  ...  ... %
%.P    ....      ...P  o%
%%%%%%%%%%%%%%%%%%%%%%%%%
