%%%%%%%%%%%%%%%%%%%%%%%%%
%...   ....      ....   %
%..  ...  ...  ...  ... %
%..  ...  ...  ...  ... %
%..    ....      .... P %
%..  P..  ...  ...  ... %
%..  ...  ...  ...  ... %
%.P    ....      ...P  .%
%%%%%%%%%%%%%%%%%%%%%%%%%
