%%%%%%%%%%%%%%%%%%%%
%....%........%....%
%....%.%%..%%.%....%
%.%..............%.%
%.%....%%  %%....%.%
%.....%   G  %.....%
%.%....%%  %%....%.%
%.%..............%.%
%....%.%%..%%.%....%
%....%........%....%
%.P..%.P....P.%..P.%
%%%%%%%%%%%%%%%%%%%%
