%%%%%%%%%%%%%%%%%%%%
%....%........%....%
%.%%.%.%%%%%%.%.%%.%
%.%..............%.%
%.%.%%.%%  %%.%%.%.%
%......%G  G%.....G%
%.%.%%.%%%%%%.%%.%.%
%.%..............%.%
%.%%.%.%%%%%%.%.%%.%
%..P.%........%..P.%
%.P..%........%.P..%
%%%%%%%%%%%%%%%%%%%%
