%%%%%%%%%%%%%%%%%%%%
%o...%........%....%
%.%%.%.%%%%%%.%.%%.%
%.%G............G%.%
%.%.%%.%%  %%.%%.%.%
%G.....%G  G%.....G%
%.%.%%.%%%%%%.%%.%.%
%.%..............%.%
%.%%.%.%%%%%%.%.%%.%
%..P.%........%..P.%
%.P..%........%.P..%
%%%%%%%%%%%%%%%%%%%%
