%%%%%%%%%%%%%%%%%%%%
%....%........%....%
%....%.%%..%%.%....%
%.%..............%.%
%.%....%%  %%....%.%
%.....%G    G%.....%
%.%....%%  %%....%.%
%.%..............%.%
%....%.%%..%%.%....%
%....%........%....%
%P...%........%P..P%
%%%%%%%%%%%%%%%%%%%%
