%%%%%%%%%%%%%%%%%%%%
%....%........%....%
%....%.%%..%%.%....%
%.%..............%.%
%.%....%%  %%....%.%
%.....%  G G  %....%
%.%....%%  %%....%.%
%.%..............%.%
%.P.P%.%%..%%P%..P.%
%....%........%....%
%.P..%.P....P.%..P.%
%%%%%%%%%%%%%%%%%%%%
