%%%%%%%%%%%%%%%%%%%%%%
%.......%  G %.......%
%..%%...%%  %%...%%..%
%..%%.%..P.....%.%%..%
%..%%.%.%%%%%%.%.%%..%
%.P...............P..%
%%%%%%%%%%%%%%%%%%%%%%
