%%%%%%%%%%%%%%%%%%%%%%
%.......%  G %.......%
%..%%...%%  %%...%%..%
%..%%.%........%.%%..%
%..%%.%.%%%%%%.%.%%..%
%.P...............P..%
%%%%%%%%%%%%%%%%%%%%%%
