%%%%%%%%%%%%%%%%%%%%%%
%.......%G  G%.......%
%..%%...%%  %%...%%..%
%..%%.%........%.%%..%
%..%%.%.%%%%%%.%.%%..%
%.........P..........%
%%%%%%%%%%%%%%%%%%%%%%
